6 3 3 3 3 3 3 3 3 3 3 3 3 3 3 7
2 4 0 0 0 0 0 0 0 0 0 0 0 0 0 1
2 0 4 0 4 0 4 0 4 0 4 4 4 4 0 1
2 0 4 0 0 0 4 0 4 0 4 0 0 0 0 1
2 0 0 0 4 4 4 0 4 0 0 0 4 0 4 1
2 0 4 0 0 0 4 0 0 4 4 4 4 0 0 1
2 0 0 4 4 0 0 4 0 4 4 0 0 0 4 1
2 0 0 0 0 0 0 0 0 0 0 0 0 0 0 1
2 0 4 4 0 0 4 0 4 0 4 4 4 4 0 1
2 4 0 4 0 4 4 0 4 0 0 0 4 0 0 1
2 4 0 0 0 0 0 0 4 4 4 0 4 0 4 1
5 5 5 5 5 5 5 5 5 5 5 5 5 5 5 5